"filename", "language", "Markdown", "Ini", "TOML", "Python", "YAML", "comment", "blank", "total"
"d:\git-davidson-eng\metrics-agent\.github\workflows\live-influx-test.yml", "YAML", 0, 0, 0, 0, 47, 6, 7, 60
"d:\git-davidson-eng\metrics-agent\README.md", "Markdown", 26, 0, 0, 0, 0, 0, 10, 36
"d:\git-davidson-eng\metrics-agent\config\__init__.py", "Python", 0, 0, 0, 0, 0, 1, 1, 2
"d:\git-davidson-eng\metrics-agent\config\influx.toml", "TOML", 0, 0, 7, 0, 0, 2, 0, 9
"d:\git-davidson-eng\metrics-agent\config\metrics_client.toml", "TOML", 0, 0, 4, 0, 0, 0, 1, 5
"d:\git-davidson-eng\metrics-agent\main.py", "Python", 0, 0, 0, 20, 0, 12, 11, 43
"d:\git-davidson-eng\metrics-agent\pyproject.toml", "TOML", 0, 0, 35, 0, 0, 4, 8, 47
"d:\git-davidson-eng\metrics-agent\pytest.ini", "Ini", 0, 2, 0, 0, 0, 0, 0, 2
"d:\git-davidson-eng\metrics-agent\src\metrics_agent\__init__.py", "Python", 0, 0, 0, 5, 0, 0, 2, 7
"d:\git-davidson-eng\metrics-agent\src\metrics_agent\agent.py", "Python", 0, 0, 0, 131, 0, 14, 35, 180
"d:\git-davidson-eng\metrics-agent\src\metrics_agent\aggregator.py", "Python", 0, 0, 0, 48, 0, 0, 16, 64
"d:\git-davidson-eng\metrics-agent\src\metrics_agent\buffer.py", "Python", 0, 0, 0, 25, 0, 0, 12, 37
"d:\git-davidson-eng\metrics-agent\src\metrics_agent\db_client.py", "Python", 0, 0, 0, 30, 0, 0, 9, 39
"d:\git-davidson-eng\metrics-agent\src\metrics_agent\metric.py", "Python", 0, 0, 0, 9, 0, 0, 4, 13
"d:\git-davidson-eng\metrics-agent\src\metrics_client\__init__.py", "Python", 0, 0, 0, 1, 0, 0, 1, 2
"d:\git-davidson-eng\metrics-agent\src\metrics_client\client.py", "Python", 0, 0, 0, 58, 0, 3, 16, 77
"d:\git-davidson-eng\metrics-agent\src\metrics_server\__init__.py", "Python", 0, 0, 0, 2, 0, 0, 2, 4
"d:\git-davidson-eng\metrics-agent\src\metrics_server\server.py", "Python", 0, 0, 0, 38, 0, 1, 9, 48
"d:\git-davidson-eng\metrics-agent\test\conftest.py", "Python", 0, 0, 0, 96, 0, 0, 32, 128
"d:\git-davidson-eng\metrics-agent\test\influxdb_testing_config.toml", "TOML", 0, 0, 7, 0, 0, 1, 0, 8
"d:\git-davidson-eng\metrics-agent\test\test_datasets.py", "Python", 0, 0, 0, 31, 0, 0, 11, 42
"d:\git-davidson-eng\metrics-agent\test\test_influxdb_metrics.py", "Python", 0, 0, 0, 67, 0, 4, 27, 98
"d:\git-davidson-eng\metrics-agent\test\test_metrics_server.py", "Python", 0, 0, 0, 39, 0, 3, 15, 57
"Total", "-", 26, 2, 53, 600, 47, 51, 229, 1008